################################################
#.#.....#...#...#.#.#...#.#.#..................#
#...#.#.#.#...#.#.....#.#.....#.##############.#
#####.#...#.###.#####.#.#.###.#.......#.#....#.#
#.....#####.#...#...#.#.#...#.#.#.#####.#.####.#
##.####.#...#.#.#.#.#.#.###.#.#.#.......#......#
#....#..#.#####.#.#...#.....###.#.#####.#.#.####
####.#.......#....###########...#.#.......#....#
#..#.#.#.#.#.##.#.#...........###.#.##########.#
#....#.#####.#..#.###.###.#.#.#...#....#...#.#.#
#.####...#...#.##..#..#.###.#...######.#.#.#.#.#
#....###.##.##.....#.##.#...#####......#.#.....#
####...#.#...#####.#....#.###.....######.#####.#
#.#..#.#.#.#.#...#.#.####.#.#.#####......#.....#
#.#..#...#.#...#...#......#.........#.#....#.#.#
#.##.##.###############.#####.#######.#.######.#
#.#...#...#...#.......#.#...#.......#.#........#
#.#.#.#.#.#.#.#.#####.#...#.#.#####.#.#.#.######
#...#.#.#...#.#.....#.#.###.#.#.....#...#.#....#
#####.#.#####.#####.#...#...#.###########.####.#
#.....#.#...#.#...#.#.###.###.#...#.....#......#
#.#####.#.#...#.#.#.#.#.#.....#.#.#.#.#.#.######
#.#...#.#.#####.#.#.#...#.#####.#.#.#.#........#
#...#...#.......#.#.#####.#.....#...#.########.#
#################.#.#.......#########.#........#
#.................#.#..#.####.........#.#.######
###############.###.##.#.#.#######.######.#....#
#...................#..#.#...#...#.....#..#..#.#
#.####################.#.#.#.#.#.#####.#.#####.#
#...#...#...#...#...#..#.#.#.#.#.#...#.#.#.....#
#.#...#...#...#...#....#...#...#...#...#...#.#.#
################################################
